02000000000000000000000000000000
01000000111100011101100000000000
01111101000111100111000000000000
01001001000010000100000000000000
01001001000010000111000000000000
01000001000011111001000000000000
01111111111010100001100000000000
01001000001000100000100000000000
01001001101010110111100000000000
01001001001010010101000000000000
01001001001011111101100000000000
01001111001010010000000000000000
01000010001010010000000000000000
01000010001010010011000000000000
01000010001101010010000000000000
01001110000101011110000000000000
01010000000101110100000000000000
01011000000101000100100000000000
01010100000101000101100000000000
01010011111101011101000000000000
01011001000001000101000000000000
01001001000001111101000000000000
01111111000000000111130000000000
00000000000000000000000000000000
00000000000000000000000000000000
00000000000000000000000000000000
00000000000000000000000000000000
00000000000000000000000000000000
00000000000000000000000000000000
00000000000000000000000000000000
00000000000000000000000000000000
00000000000000000000000000000000
